6 6 6 6 6 6 6 6 6 6 6 6 6 6 6 8
6 0 0 0 0 0 1 1 1 0 0 0 0 0 0 6
6 0 0 0 0 0 0 4 0 0 0 0 0 0 0 6
6 0 0 0 0 0 3 1 3 0 0 0 0 0 0 6
6 0 0 0 0 0 0 1 0 0 0 0 0 0 0 6
6 0 0 0 0 0 0 1 0 0 0 0 0 0 0 6
6 0 0 0 0 0 0 1 0 0 0 0 0 0 0 6
6 0 0 0 0 0 0 1 0 0 0 0 0 0 0 6
6 0 0 0 0 0 0 1 0 0 0 0 0 0 0 6
6 0 0 0 0 0 0 -1 0 0 0 0 0 0 0 6
6 0 0 0 0 0 0 1 0 0 0 0 0 0 0 6
6 0 0 0 0 0 0 1 0 0 0 0 0 0 0 6
6 0 0 0 0 0 0 1 0 0 0 2 0 0 0 6
6 0 0 0 0 0 0 1 0 0 0 2 0 0 0 6
6 0 0 0 0 0 0 1 0 0 0 2 0 0 0 6
7 6 6 6 6 6 6 6 6 6 6 6 6 6 6 6